################################################################################
#                                                                              #
#                                                                              #
#                                                                              #
#                                 ########                                     #
#                                 ########                                     #
#                                 ########                                     #
#                                                                              #
#                                                                              #
#                                                                              #
#                                                                              #
#                                                                              #
#                                                                              #
#                                                                              #
#                                                                              #
#                                                                              #
#                                                                              #
#                                                                              #
#                                                                              #
#                                                                              #
################################################################################
