################################################################################
#                                                                              #
#                                                                              #
#                                                                              #
#        ##########################           ##########################       #
#        ##########################           ##########################       #
#                                                                              #
#                                                                              #
#                                                                              #
#                                                                              #
#                                                                              #
#                                                                              #
#                                                                              #
#                                                                              #
#                                                                              #
#                                                                              #
#                                                                              #
#                                                                              #
#                                                                              #
#                                                                              #
################################################################################
