################################################################################
#                                                                              #    
#                                                                              #
#                                                                              #
#                                                                              #
#                 #                                  #                         #
#                 #                                  #                         #
#                                                                              #
#                                                                              #
#                 #                                  #                         #
#                 #                                  #                         #
#                 #                                  #                         #
#                                                                              #
#                                                                              #
#                                                                              #
#                                                                              #
#                                 #                                             #
#                                                                              #
#                                                                              #
################################################################################
